35
21
                                   
XXXXXXXXXXXXXXXXXXXXXXXXXXXXXXXXXXX
XEOOOOOOOOOOOOOOOOOO   OOOOOOO#OOOX
XOOOOO  OOOOORRROOOOOOOOOOOOOOOOOOX
XOOOOOOOOO#ROOOOOOOOOOOOOOOOOOOOOOX
XOOOOOOOOOOROOOOOOOOOXOOOOOO OOOOOX
XXXXXXXXXOOOOO     OOXOOOOO OOOOOOX
XO#O   OOOOOROOOOOOOOXOOOOO OOOOROX
XXXXXXXXOOOOOOOROOOOXOOOOO  OOOORRX
XOOOOOOOOOOOOOOOOOOOOXOOOOOOOOOOOOX
XOOOOOOOO     OOOOOOOXOOOOOOOOO ##X
XOOOOOOXXXXXXXXXXXXXXXXXXXXXXXXXXXX
XOOO OOXOOOOOOOOOOOOOOOOOROOOOOOOOX
XOOO OOXOOOO   OORROOOO OOOOOOROOOX
XOOOOOOXOOOOOOOOORROOO OOOOXXOROOOX
XOOOOOOOOOO    OOOROOOOOOOO X#ROOOX
XOOOXXXXXOOOOOOOOOROOOOOOOOOOOXOR#X
XOOOOOOOXOOOOOROOOOOO#OOOOOOOOXOORX
XOOO#OOOXOOOOOROOOOOOOOOOOOOOOXOOOX
XOOOOOOOXOOOOORRRROOOOOOO     XO@OX
XXXXXXXXXXXXXXXXXXXXXXXXXXXXXXXXXXX